李金哲	李金哲
亚历山大・门科夫	亚历山大・门科夫
布莱辛・奥卡格巴雷	布莱辛・奥卡格巴雷
达里娅・克里什娜	达里娅・克里什娜
贾斯汀・加特林，加特林	贾斯汀・加特林，加特林
泰森・盖伊，盖伊	泰森・盖伊，盖伊
李延熙	李延熙
基拉尼・詹姆斯	基拉尼・詹姆斯
约翰・布雷克	约翰・布雷克
莫有雪	莫有雪
孙子智美	孙子智美
贾斯汀・加特林	贾斯汀・加特林
费米・奥古诺德	费米・奥古诺德
卡斯特尔・塞门亚	卡斯特尔・塞门亚
埃里森・菲利克斯	埃里森・菲利克斯
阿什顿・伊顿	阿什顿・伊顿
拉维尼亚・米洛索维奇	拉维尼亚・米洛索维奇
陈诗华	陈诗华
刘思媛	刘思媛
艾莉西亚・萨克拉莫尼	艾莉西亚・萨克拉莫尼
鹤见虹子	鹤见虹子
菲比・米尔斯	菲比・米尔斯
斯维特拉娜・霍尔金娜	斯维特拉娜・霍尔金娜
丘索维金娜	丘索维金娜
孙妍在	孙妍在
肖恩・约翰逊	肖恩・约翰逊
福原爱	福原爱
张怡宁	张怡宁
刘诗雯	刘诗雯
许昕	许昕
郝帅	郝帅
樊振东	樊振东
萨姆索诺夫	萨姆索诺夫
蒂姆・波尔	蒂姆・波尔
柳承敏	柳承敏
朱世赫	朱世赫
高宁	高宁
迪米特里・奥恰洛夫	迪米特里・奥恰洛夫
吴尚垠	吴尚垠
水谷隼	水谷隼
费雷塔斯	费雷塔斯
木村沙织	木村沙织
石井优希	石井优希
朱婷	朱婷
杨昊	杨昊
张平	张平
刘晓彤	刘晓彤
杨方旭	杨方旭
若泽・萨列斯	若泽・萨列斯
高仓千惠美	高仓千惠美
卢卡斯	卢卡斯
张磊	张磊
陈伊娜	陈伊娜
张萍	张萍
艾q博柯娃・莎宾娜	艾q博柯娃・莎宾娜
麦克罗伊	麦克罗伊
斯科特	斯科特
伍兹	伍兹
史蒂夫・史翠克	史蒂夫・史翠克
米克尔森	米克尔森
福瑞克	福瑞克
凯默尔	凯默尔
魏圣美	魏圣美
冯珊珊	冯珊珊
张连伟	张连伟
梁文冲	梁文冲
崔罗莲	崔罗莲
黄有谊	黄有谊
关天朗	关天朗
曾雅妮	曾雅妮
罗伊・麦克罗伊	罗伊・麦克罗伊
亚当・斯科特	亚当・斯科特
泰格・伍兹	泰格・伍兹
菲尔・米克尔森	菲尔・米克尔森
吉姆・福瑞克	吉姆・福瑞克
马丁・凯梅尔	马丁・凯梅尔
凯文・杜兰特	凯文・杜兰特
卡梅隆・安东尼	卡梅隆・安东尼
勒布朗・詹姆斯	勒布朗・詹姆斯
泰伦・卢	泰伦・卢
凯里・欧文	凯里・欧文
保罗・乔治	保罗・乔治
哈里森・巴恩斯	哈里森・巴恩斯
保罗・加索尔	保罗・加索尔
赵爽	赵爽
林书豪	林书豪
王哲林	王哲林
詹姆斯・哈登	詹姆斯・哈登
林志杰	林志杰
德怀特・霍华德	德怀特・霍华德
林俊红	林俊红
李强	李强
李绘	李绘
马剑飞	马剑飞
雷声	雷声
郭文B	郭文B
傅园慧	傅园慧
董斌	董斌
邓薇	邓薇
邓书弟	邓书弟
陈佩娜	陈佩娜
钟天使	钟天使
张培萌	张培萌
张靖靖	张靖靖
张富升	张富升
张彬彬	张彬彬
马晋	马晋
徐晨	徐晨
魏萌	魏萌
王智伟	王智伟
王铮	王铮
王嘉男	王嘉男
王大鹏	王大鹏
孙玉洁	孙玉洁
苏海航	苏海航
司雅杰	司雅杰
施廷懋	施廷懋
蒲琪峰	蒲琪峰
潘强	潘强
马龙	马龙
骆羽	骆羽
骆赢	骆赢
龙清泉	龙清泉
刘蕙瑕	刘蕙瑕
梁婉霞	梁婉霞
李宗伟	李宗伟
李雪芮	李雪芮
李晓霞	李晓霞
李玲蔚	李玲蔚
李丹	李丹
惠子程	惠子程
高阳	高阳
董栋	董栋
谌龙	谌龙
陈晓婷	陈晓婷
陈定	陈定
陈艾森	陈艾森
洪炜	洪炜
柴飚	柴飚
曹缘	曹缘
曹逸飞	曹逸飞
张晓楠	张晓楠
谢震业	谢震业
魏宁	魏宁
商春松	商春松
林超攀	林超攀
蔡泽林	蔡泽林
马林	马林
李龙大	李龙大
柳延星	柳延星
塞蒂亚万	塞蒂亚万
阿桑	阿桑
金沙朗	金沙朗
松友美佐纪	松友美佐纪
高桥礼华	高桥礼华
唐渊s	唐渊s
田卿	田卿
内瓦尔	内瓦尔
拉特查诺	拉特查诺
阿赛尔森	阿赛尔森
J・约根森	J・约根森
桃田贤斗	桃田贤斗
迈克尔・菲尔普斯	迈克尔・菲尔普斯
北岛康介	北岛康介
保罗・比德尔曼	保罗・比德尔曼
徐嘉余	徐嘉余
迈克霍顿	迈克霍顿
史婧林	史婧林
亚当・佩蒂	亚当・佩蒂
达娜・沃尔默	达娜・沃尔默
凯蒂・莱德基	凯蒂・莱德基
瑞贝卡・阿德灵顿	瑞贝卡・阿德灵顿
杨建	杨建
瑞安・罗切特	瑞安・罗切特
卡格诺托	卡格诺托
汤姆・戴利	汤姆・戴利
杰克・拉夫尔	杰克・拉夫尔
郭晶晶	郭晶晶
石雨豪	石雨豪
黄常洲	黄常洲
女足	中国女足
王莲媛	王莲媛
段静莉	段静莉
何雯娜	何雯娜
杨哲	杨哲
尚春松	尚春松
於秀敏	於秀敏
宫金杰	宫金杰
苏炳添	苏炳添
陈颖	陈颖
李越宏	李越宏
杜丽	杜丽
刘洋	刘洋
赵芸蕾	赵芸蕾
张楠	张楠
庞伟	庞伟
张文秀	张文秀
范忆琳	范忆琳
高兴龙	高兴龙
邢宇	邢宇
许安琪	许安琪
曹忠荣	曹忠荣
任茜	任茜
吴敏霞	吴敏霞
何姿	何姿
胡斌渊	胡斌渊
张继科	张继科
周渊亭	周渊亭
于洋	于洋
吴景彪	吴景彪
陈若琳	陈若琳
陈倩	陈倩
林丹	林丹
王仪涵	王仪涵
丁宁	丁宁
吕会会	吕会会
朱启南	朱启南
巩立姣	巩立姣
易思玲	易思玲
高磊	高磊
尤浩	尤浩
黎雅君	黎雅君
王镇	王镇
邱波	邱波
林跃	林跃
傅海峰	傅海峰
何超	何超
杨浩然	杨浩然
周倩	周倩
周凤	周凤
钟雪纯	钟雪纯
体操女队	中国体操女队
体操男队	中国体操男队
水球队	中国水球队
射箭女队	中国射箭女队
射箭男队	中国射箭男队
女排	中国女排
女篮	中国女篮
男篮	中国男篮
队	中国队
郑姝音	郑姝音
赵声波	赵声波
张家玮	张家玮
张国伟	张国伟
张成龙	张成龙
谵利军	谵利军
于颂	于颂
叶诗文	叶诗文
叶尔兰别克	叶尔兰别克
徐莉佳	徐莉佳
谢文骏	谢文骏
向艳梅	向艳梅
吴静钰	吴静钰
王祯	王祯
王妍	王妍
王路敏	王路敏
田涛	田涛
孙杨	孙杨
石智勇	石智勇
任成远	任成远
任灿灿	任灿灿
曹源	曹源
秦凯	秦凯
宁泽涛	宁泽涛
孟书平	孟书平
吕斌	吕斌
陆滢	陆滢
刘湘	刘湘
刘伟	刘伟
刘虹	刘虹
克里斯・保罗	克里斯・保罗
格雷格・奥登	格雷格・奥登
安东尼・本内特	安东尼・本内特
丹尼・格兰杰	丹尼・格兰杰
贾巴里・帕克	贾巴里・帕克
克莱・汤普森	克莱・汤普森
孙悦	孙悦
易建联	易建联
朱芳雨	朱芳雨
王仕鹏	王仕鹏
周鹏	周鹏
王治郅	王治郅
尤塞恩・博尔特	尤塞恩・博尔特
兹拉坦・伊布拉西莫维奇	兹拉坦・伊布拉西莫维奇
大卫・席尔瓦	大卫・席尔瓦
内马尔・达席尔瓦	内马尔・达席尔瓦
托马斯・穆勒	托马斯・穆勒
阿尔瓦罗・莫拉塔	阿尔瓦罗・莫拉塔
里奥・梅西	里奥・梅西
马尔科・罗伊斯	马尔科・罗伊斯
罗纳尔迪尼奥	罗纳尔迪尼奥
塞尔吉奥・罗梅罗	塞尔吉奥・罗梅罗
马科斯・罗霍	马科斯・罗霍
阿尔杰・罗本	阿尔杰・罗本
里卡多・伊泽克森・多斯・桑托斯・雷特	里卡多・伊泽克森・多斯・桑托斯・雷特
瑞恩・吉格斯	瑞恩・吉格斯
马里奥・格策	马里奥・格策
梅苏特・厄齐尔	梅苏特・厄齐尔
孟菲斯・德佩	孟菲斯・德佩
大卫・德赫亚	大卫・德赫亚
大卫・路易斯	大卫・路易斯
曾诚	曾诚
祁宏	祁宏
恩诺克・巴洛特利	恩诺克・巴洛特利
郑大世	郑大世
本田圭佑	本田圭佑
菲尔・琼斯	菲尔・琼斯
罗纳尔多・德・阿西斯・莫雷拉	罗纳尔多・德・阿西斯・莫雷拉
谭茹殷	谭茹殷
顾雪宋	顾雪宋
孙一文	孙一文
郭艾伦	郭艾伦
赵继伟	赵继伟
张梦雪	张梦雪
陈海威	陈海威
陈欣怡	陈欣怡
李朱濠	李朱濠
李广源	李广源
华天	华天
程训钊	程训钊
吕小军	吕小军
郝佳露	郝佳露
孟苏平	孟苏平
薛长锐	薛长锐
赵帅	赵帅
曹硕	曹硕
徐蕊	徐蕊
汪顺	汪顺
史婧琳	史婧琳
毛艺	毛艺
谭佳薪	谭佳薪
潘飞鸿	潘飞鸿
黄文仪	黄文仪
吕秀芝	吕秀芝
孙文雁	孙文雁
呙俐	呙俐
顾笑	顾笑
汤梦妮	汤梦妮
李晓璐	李晓璐
曾珍	曾珍
梁馨枰	梁馨枰
尹成昕	尹成昕
黄雪辰	黄雪辰
赵云蕾	赵云蕾
孙亚楠	孙亚楠
张凤柳	张凤柳
尹军花	尹军花
胡建关	胡建关
李倩	李倩
袁心h	袁心h
龚翔宇	龚翔宇
魏秋月	魏秋月
张常宁	张常宁
徐云丽	徐云丽
惠若琪	惠若琪
林莉	林莉
丁霞	丁霞
颜妮	颜妮
马克・霍顿	马克・霍顿
拜尔斯	拜尔斯