三星手机	三星
Samsung	三星
联想 手机	联想
联想 电脑	联想
Lenovo	联想
联想 VIBEUI	联想
联想 智能	联想
阿迪达斯	阿迪达斯
Adidas	阿迪达斯
耐克	耐克
Nike	耐克
nike	耐克
361°	361°
361度	361°
东风日产	东风日产
尼桑 Nissan	东风日产
宝马	宝马
BMW	宝马
bmw	宝马
百威	百威
Budweiser	百威
松下	松下
Panasonic	松下
安利 纽崔莱	安利纽崔莱
纽崔莱	安利纽崔莱