瑜伽课	瑜伽课
瑜伽馆	瑜伽馆
体育中心	体育中心
体育馆	体育馆
体育场	体育场
球馆	球馆
球场	球场
健身中心	健身中心
健身房	健身房
公园	公园
操场	操场
宴会	宴会
演唱会	演唱会
休闲吧	休闲吧
网吧	网吧
书吧	书吧
美术馆	美术馆
美容院	美容院
麦当劳	麦当劳
肯德基	肯德基
酒吧	酒吧
电影院	电影院
餐吧	餐吧
博物馆	博物馆
必胜客	必胜客
吧台	吧台
KTV	KTV
住宿	住宿
中学	中学
学校	学校
宿舍	宿舍
校园	校园
图书馆	图书馆
食堂	食堂
上课	上课
寝室	寝室
课室	课室
教学楼	教学楼
教室	教室
高中	高中
大学	大学
书局	书局
书店	书店
坐车	坐车
在路上	在路上
开车	开车
加油站	加油站
机场	机场
火车	火车
航空	航空
公交	公交
公共交通	公共交通
高铁	高铁
飞机	飞机
动车	动车
电瓶车	电瓶车
电车	电车
地铁	地铁
登机	登机
乘地铁	乘地铁
车站	车站
bus	bus
研磨时光	研磨时光
星享卡	星享卡
星爸爸	星爸爸
星巴克	星巴克
太平洋	太平洋
漫咖啡	漫咖啡
麦当劳	麦当劳
肯德基	肯德基
咖啡之翼	咖啡之翼
咖啡屋	咖啡屋
咖啡厅	咖啡厅
咖啡陪你	咖啡陪你
咖啡馆	咖啡馆
咖啡店	咖啡店
豪丽斯	豪丽斯
餐厅	餐厅
Starbucks	Starbucks
hollys	hollys
COSTA	COSTA
caffe bene	caffe bene
自家	自家
在家	在家
阳台	阳台
屋里	屋里
卧室	卧室
我家	我家
天台	天台
客厅	客厅
家中	家中
家里	家里
房间	房间
厨房	厨房
游乐园	游乐园
游乐场	游乐场
泳池	泳池
沙滩	沙滩
码头	码头
旅游	旅游
郊游	郊游
海滩	海滩
海边	海边
公园	公园
商店	商店
商场	商场
卖场	卖场
超市	超市
便利店	便利店
百货公司	百货公司
下班	下班
上班	上班
开会	开会
会议室	会议室
公司	公司
单位	单位
办公桌	办公桌
办公室	办公室
运动	运动
瑜伽	瑜伽
有氧	有氧
游泳	游泳
夜跑	夜跑
无氧	无氧
徒步	徒步
跆拳道	跆拳道
深蹲	深蹲
射箭	射箭
拳击	拳击
器械	器械
骑	骑
跑步	跑步
攀岩	攀岩
爬山	爬山
举铁	举铁
健身	健身
户外	户外
打球	打球
晨练	晨练
做指甲	做指甲
自驾游	自驾游
桌游	桌游
追剧	追剧
游戏	游戏
音乐	音乐
夜店	夜店
演出	演出
演唱会	演唱会
小说	小说
温泉	温泉
听相声	听相声
听歌	听歌
摄影	摄影
晒太阳	晒太阳
泡温泉	泡温泉
泡吧	泡吧
捏脚	捏脚
密室	密室
美剧	美剧
美甲	美甲
旅游	旅游
旅行	旅行
撸串	撸串
唠嗑	唠嗑
看综艺	看综艺
看直播	看直播
看展览	看展览
看剧	看剧
看节目	看节目
看海景	看海景
看电影	看电影
绘画	绘画
话剧	话剧
画画	画画
喝茶	喝茶
汗蒸	汗蒸
逛街	逛街
购物	购物
斗地主	斗地主
电玩	电玩
电视剧	电视剧
打牌	打牌
打麻将	打麻将
吃饭	吃饭
按摩	按摩
SPA	SPA
K歌	K歌
作业	作业
学习	学习
论文	论文
考试	考试
高考	高考
复习	复习
背书	背书
阅读	阅读
看书	看书
读书	读书
读了	读了
自驾	自驾
开车	开车
驾驶	驾驶
叙旧	叙旧
小聚	小聚
趴体	趴体
聚在一起	聚在一起
聚一聚	聚一聚
聚聚	聚聚
聚会	聚会
聚餐	聚餐
轰趴	轰趴
party	party
夜班	夜班
上班	上班
课件	课件
开会	开会
加班	加班
会议	会议
工作	工作
赶项目	赶项目
赶进度	赶进度
备课	备课
熬夜	熬夜
周日	周日
周末	周末
周六	周六
休息天	休息天
休息日	休息日
星期天	星期天
双休日	双休日
礼拜天	礼拜天
礼拜六	礼拜六
假期	假期
中午	中午
下午茶	下午茶
下午	下午
午间	午间
午后	午后
午茶	午茶
午餐	午餐
昨晚	昨晚
整晚	整晚
夜晚	夜晚
夜里	夜里
晚上	晚上
晚餐	晚餐
通宵	通宵
每晚	每晚
凌晨	凌晨
今晚	今晚
傍晚	傍晚
半夜	半夜
早上	早上
早起	早起
早晨	早晨
早餐	早餐
早安	早安
一早	一早
上午	上午
清早	清早
清晨	清晨
起床	起床
今早	今早
周一	周一
周五	周五
周四	周四
周三	周三
周二	周二
星期一	星期一
星期五	星期五
星期四	星期四
星期三	星期三
星期二	星期二
下班	下班
上班	上班
工作日	工作日